1111111111111111111
10100000E000C00C011
11C0000100000000001
10CCC00001101C01001
10011000001100C00C1
1C0C1C0000000000P01
100C100CC0001000101
1000010000C00000101
1000000000100000001
100010000010001C0C1
1000000010000001C01
1000001000000000001
101000000C0C0C00001
100000100000000C001
1111111111111111111