1111111
11CCCE1
11CPCC1
1111111